                                       
             55                f       
     555                       i 55    
                     99        i       
                    999        i       
                   9999        i       
                  99999        i       
 2232            999999        i       
                9999999        i    w  
            44 99999999        i    dd 
            44999999999        9    dd 
111111111111111111111111111111111111111
111111111111111111111111111111111111111